0,0,0,0,0,0,0,0,
0,9,0,3,3,0,9,0,
0,0,1,1,1,1,0,0,
0,3,1,8,8,1,3,0,
0,3,1,8,8,1,3,0,
0,0,1,1,1,1,0,0,
0,9,0,3,3,0,9,0,
0,0,0,0,0,0,0,0